1111111111111
1001000P00C11
1000000111111
100011E100111
1111111111111