1111111111111
100100C000C11
1000000111001
1P0011E10C011
1111111111111