1111111111111
1001000000011
1000000111001
1P0011E100011
1111111111111