1111111111111
10010000000C1
1000011111001
1P0011E000C11
1111111111111