1111111111111111111111111111111111
1E0000001000000000000C0K0000000001
1100010100100001101001000000010101
1010010010101011001001000000010101
1P0000000C00C0010000000000000000C1
1111111111111111111111111111111111